%%%%%%%%%%%%%%%%%%%%
%......%%%%%%......%
%.%%...  G   ...%%.%
%.%%.%.%%%%%%.%.%%.%
% .. ..  P  .. .. .%
%%%%%%%%%%%%%%%%%%%%
