%%%%%%%%%%
% . G P  %
%        %
%%%%%%%%%%