%%%%%%%%%%
% . P G  %
% .    . %
%%%%%%%%%%