%%%%%%%%%%
%  G P.  %
%%%%%%%%%%