%%%%%%%%
%% %   %
%%.%P .%
%. G.  %
% %   %%
%%%%%%%%
