%%%%%%%%
%G. %  %
% %    %
%  G   %
%    GP%
%%%%%%%%
