%%%%%%%%%
%..% .  %
% . G  P%
%.  .   %
%  % . G%
%  %%   %
%%%%%%%%%
