%%%%%%%
%%    %
% G   %
%     %
%..% P%
%%%%%%%
