%%%%%%%%%%
%   G  ..%
%%    . .%
%   .   .%
%    .   %
%   .  . %
%       P%
%%%%%%%%%%
