%%%%%%%
%G    %
%  .  %
%%%   %
%    P%
%%%%%%%
