%%%%%%%%%%
%      .%%
%   .  % %
%.      %%
%. %  G% %
%.  .%   %
%    . %P%
%%%%%%%%%%
