%%%%%%
%  . %
%    %
%%   %
%% % %
%.G  %
%..  %
% .  %
%. .P%
%%%%%%
