%%%%%%%%
%..G. .%
% %   %%
% G  % %
% .  .%%
%.  % .%
%.% %  %
%      %
%.   .P%
%%%%%%%%
