%%%%%%%%
%%     %
%     .%
%%% . G%
%  %P  %
%%%    %
%% .   %
% .% . %
%%%%%%%%
