%%%%%%
%% G.%
%    %
%.  %%
%%..P%
%%%%%%
