%%%%%%%%%%
% .% .   %
%  %  G  %
%     %  %
%  . . ..%
%.   P   %
%.   .% .%
%  %   % %
%%%%%%%%%%
