%%%%%%%%%
%.. G . %
%   . . %
% %  %  %
% . %.. %
%  %    %
%   %%.P%
%%%%%%%%%
