%%%%%%%%%
% G     %
%  %    %
%  .  . %
%     . %
%  .  . %
%  .  . %
%P . .  %
%%%%%%%%%
