%%%%%%%%
% G   %%
% % %  %
%  %.  %
%      %
%.% % P%
%%%%%%%%
