%%%%%%
%%% G%
%  ..%
%   %%
%   P%
%%%%%%
