%%%%%%%%%%
%       %%
%      G%%
%    %   %
% .     P%
%%%%%%%%%%
