%%%%%%
% .G %
%   %%
% % %%
%  .P%
%%%%%%
