%%%%%%%%%
%       %
%  G    %
% %     %
%    .  %
%     %.%
% %   %P%
%%%%%%%%%
