%%%%%%%%
%% .G  %
%      %
%%     %
% P   %%
%.%    %
%    % %
%    G%%
%%%%%%%%
