%%%%%%%%
% .G   %
%      %
%   % .%
%%%   .%
% G   .%
%    %P%
%%%%%%%%
