%%%%%%%%
% G % %%
% %    %
%     %%
%%  % P%
%%%%%%%%
