%%%%%%%%%
%%      %
%   . %.%
%  . .  %
%    .GP%
%%%%%%%%%
