%%%%%%%%%%
%  P   G %
%  %%    %
%   .%  %%
%       .%
%.   ..  %
%. %%  ..%
%.    .  %
%%%%%%%%%%
