%%%%%%%%%
%    . %%
%       %
%      %%
%%     %%
%       %
%.  G%  %
%   . %P%
%%%%%%%%%
