%%%%%%%%%
%% .G  %%
% .  %% %
%. . . %%
%%%GG  .%
%  .  %P%
%%%%%%%%%
