%%%%%%
%%.%.%
%. %.%
%G%  %
%   P%
%%%%%%
