%%%%%%%
% %G .%
%.    %
%     %
%G%.  %
%     %
%G   %%
%  . P%
%%%%%%%
