%%%%%%%%%%
%  .     %
%   ...% %
%  % %   %
%    .   %
%  .     %
%  .%.G  %
%..    . %
%P    %  %
%%%%%%%%%%
