%%%%%%%%%%
%% .G   .%
%   %    %
%   .    %
%     .  %
%        %
%%      P%
%%%%%%%%%%
