%%%%%%%%
%%     %
%      %
%     .%
%%. G P%
%%%%%%%%
