%%%%%%%%
%. G.  %
% %    %
%%.    %
%% .. P%
%%%%%%%%
