%%%%%%%%%%
%        %
%   %  GG%
% . G    %
%%       %
%    % G %
%   %.   %
%   .%% P%
%%%%%%%%%%
