%%%%%%
% .G.%
%    %
%%% .%
%   P%
%%%%%%
