%%%%%%
% G. %
% %  %
%  . %
%   P%
%%%%%%
