%%%%%%%%
% G  % %
%      %
%%  . P%
%.%.   %
% %    %
%%.%   %
%      %
%%     %
%%%%%%%%
