%%%%%%
%. ..%
%%G  %
%  . %
%%. P%
%%%%%%
