%%%%%%%%%
%  .%   %
%% .    %
% G .   %
%  .  G %
%%    . %
%.  .  .%
%%%    P%
%%%%%%%%%
