%%%%%%%%%
%%  %   %
%.      %
%  .   .%
%  .    %
%   %%. %
%.% G  P%
%%%%%%%%%
