%%%%%%%%%
% ..   %%
%    %  %
% . .   %
%       %
%   %   %
%G  . % %
%       %
%G.    P%
%%%%%%%%%
