%%%%%%%
%%G%  %
%.    %
% .%  %
%% %  %
% P. .%
%     %
%%%%%%%
