%%%%%%%%
% G    %
%      %
%    %.%
% ..%% %
% .% . %
%.  . P%
%%%%%%%%
