%%%%%%%
%  % %%
%    .%
%%.   %
% .   %
%   . %
% . G %
%%  .P%
%%%%%%%
