%%%%%%%%%%
% .    % %
%   %   %%
%  P    .%
% %   %  %
%      .G%
%%%%%%%%%%
