%%%%%%%%
%. G   %
%. %%  %
%%%    %
% %    %
% %   P%
%%%%%%%%
