%%%%%%%%%
% .G    %
%.  P.  %
% %%%.  %
%       %
%%%%%%%%%
