%%%%%%%%%
% %    G%
%  %  G %
%. % GG %
%%    . %
%% .%  P%
%%%%%%%%%
