%%%%%%%%%
%   .   %
%       %
%     % %
% PG %  %
%      .%
%%%%%%%%%
