%%%%%%%%%
%%.%    %
%%..   .%
%   %%.G%
%      P%
%%%%%%%%%
