%%%%%%%%
%.  %. %
%    %.%
%   % .%
%. G G %
%. .G .%
%%. %. %
%     P%
%%%%%%%%
