%%%%%%%
% G % %
%   .%%
%P. % %
%     %
%.  % %
%%%%%%%
