%%%%%%%%%%
%     %P%%
%   .  . %
%G       %
%  %.    %
%  .     %
%%%%%%%%%%
