%%%%%%%%%
%   % . %
%   % %.%
%G      %
%      %%
%..  . P%
%%%%%%%%%
