%%%%%%%
%.    %
%  % .%
%   .%%
% %   %
% % .%%
% G . %
%  ..P%
%%%%%%%
