%%%%%%%%%%
%  .  %% %
% .  % %.%
% . G  % %
%    .   %
% ..     %
%% ...  %%
%  %  %  %
%%G%. . P%
%%%%%%%%%%
