%%%%%%%%%%
%...% %G %
% .      %
%. P  %%%%
% .    %.%
%%%%%%%%%%
