%%%%%%%%
%% .   %
%      %
% G %  %
% .    %
%  . % %
% G  . %
%  G.%P%
%%%%%%%%
