%%%%%%%%
% G  % %
%      %
%...%  %
%   %  %
%    %P%
%%%%%%%%
