%%%%%%
%. %G%
%    %
%.   %
%    %
%    %
%.   %
% P .%
%%%%%%
