%%%%%%%%
%.   % %
%%    .%
% .    %
%  %  %%
%.P%.  %
%      %
%   G  %
%     %%
%%%%%%%%
