%%%%%%
% G  %
%  % %
%% % %
% %.P%
%%%%%%
