%%%%%%%%
% G  ..%
%%     %
% %% .%%
%%   ..%
%%%   .%
%   P .%
%   .% %
%%  % .%
%%%%%%%%
