%%%%%%%%%
%  .    %
% .   % %
% G.    %
%      .%
%.%. . P%
%%%%%%%%%
