%%%%%%
% % %%
% G  %
%  G%%
%G .P%
%%%%%%
