%%%%%%%
%% G% %
%..   %
%..   %
%     %
%%    %
%     %
% % . %
%   .P%
%%%%%%%
