%%%%%%%%%%
% G      %
%. %.  ..%
%%%   .  %
%   . %%P%
%%%%%%%%%%
