%%%%%%
% G. %
%% . %
% .. %
%   P%
%%%%%%
