%%%%%%%%%
%   %.G %
% .     %
%   G   %
%   %  P%
%%%%%%%%%
