%%%%%%%%
% G    %
% .   .%
%     .%
%. %   %
%      %
%% ..%P%
%%%%%%%%
