%%%%%%
% G. %
%%   %
%    %
%  . %
%. %%%
%   P%
%%%%%%
