%%%%%%
% G%%%
%    %
%.   %
%   %%
% . P%
%%%%%%
