%%%%%%%%%
% G%.%% %
% .    %%
%       %
%   .  %%
%      .%
%      P%
%%%%%%%%%
