%%%%%%%%
%.     %
%G%%   %
%   G. %
%%.%   %
%  G   %
%.     %
%. .% P%
%%%%%%%%
