%%%%%%%%%
% .     %
%.    . %
%  .P% %%
%    G  %
%  %    %
%%%%%%%%%
