%%%%%%%%%%
%% % % . %
%   G  . %
% .      %
%       P%
%%%%%%%%%%
