%%%%%%%
%% .  %
%%%%  %
%    .%
%  %  %
%   . %
%%G  P%
%%%%%%%
