%%%%%%
%  % %
%.   %
% G P%
% %. %
%   .%
%  ..%
%  .%%
%%%%%%
