%%%%%%%%
%    . %
%     .%
%      %
%      %
% .    %
%%     %
%  . %G%
% .  .P%
%%%%%%%%
