%%%%%%%%%%
% .   G  %
% .   % %%
%.  G . .%
% .  . G.%
%      %%%
%     P  %
%        %
% .      %
%%%%%%%%%%
