%%%%%%%%
%. .G  %
%  ..%%%
% . . .%
%% %% .%
%  % ..%
%  .   %
%%P    %
%      %
%%%%%%%%
