%%%%%%%
%.    %
% G  .%
%%    %
%  %% %
%..  P%
% .. G%
%%%%%%%
