%%%%%%%%%%
% P%    %%
%.    G% %
% .. %  .%
%    G  .%
%G   % % %
%   %  %.%
% %. .   %
% %   .  %
%%%%%%%%%%
