%%%%%%%%%
% G  %% %
% ..%   %
%     . %
%%      %
%      .%
% .  .% %
%%  %.  %
% %P    %
%%%%%%%%%
