%%%%%%%%%
%    G  %
%       %
%   .   %
%. G.  P%
%%%%%%%%%
