%%%%%%%%%
%       %
%   ..  %
%    .G %
%. %  . %
%%G     %
%   .% P%
%%%%%%%%%
