%%%%%%%%%%
%  .  .% %
%%. %    %
%   %.   %
% G%. .  %
% %   % P%
%%%%%%%%%%
