%%%%%%
%    %
%.  G%
%    %
%..  %
%   .%
%%%  %
%.%%P%
%%%%%%
