%%%%%%%%%%
%.%      %
%        %
%    ..  %
%%  .  ..%
%. .%G  P%
%%%%%%%%%%
