%%%%%%%%%
%       %
% %  % .%
%.G  %. %
%   .  P%
%%%%%%%%%
