%%%%%%
% G  %
%    %
% %% %
%   P%
%%%%%%
