%%%%%%%%%
%  %    %
%.%%.   %
% .G %  %
%G      %
%%%.  % %
%% G    %
%     %P%
%%%%%%%%%
