%%%%%%%
% . % %
%   .G%
%  .  %
%G %.%%
%  .  %
%   .P%
%%%%%%%
