%%%%%%%%%%
%  .%  %.%
%      G %
%       %%
% .      %
%.% .    %
% .%    .%
%.  .    %
%      GP%
%%%%%%%%%%
