%%%%%%%%%%
%% % %   %
%%       %
%   %    %
%   .    %
%.       %
%   G .. %
%. G  . %%
%  .% ..P%
%%%%%%%%%%
