%%%%%%%%%%
% P  % %%%
% % %% %%%
%..  .   %
%     G  %
% .      %
% . G .G.%
%   %   .%
%%%%%%%%%%
