%%%%%%%%
%    ..%
%..  % %
%G . . %
%   .  %
%    . %
% .   P%
%%%%%%%%
