%%%%%%%%
%.     %
% %G.  %
% %    %
%.%    %
%.  % .%
%   G%P%
%%%%%%%%
