%%%%%%%%%
%. G  . %
%%    .P%
%  %  . %
% % .   %
%%%%%%%%%
