%%%%%%%
% G% .%
%  %  %
%    %%
% % .P%
%%%%%%%
