%%%%%%%%
%     .%
%  %  .%
%.   % %
%%%    %
%G   G %
% G   .%
% . % P%
%%%%%%%%
